NO ./textures/texture_north.xpm
SO ./textures/texture_south.xpm
WE ./textures/texture_west.xpm
EA ./textures/texture_east.xpm

F 220,100,0
C 135,206,235

11111111111
10000000001
10000010001
10S00010001
10000000001
11111111111