NO ./textures/texture_north.xpm
SO ./textures/texture_south.xpm
WE ./textures/texture_west.xpm
EA ./textures/texture_east.xpm

F 100,150,200
C 50,100,150

1111111111111111111111111111111111111111
10000000000000000S0000000000000000000001
1011111111111111101111111111111111111101
101             101                  101
101             101                  101
101             101                  101
1011111111111111101111111111111111111101
1000000000000000000100000000000000000001
1111111111111111100101111111111111111111
               1100101                   
1111111111111111100101111111111111111111
1000100000000000000100100000000001000001
1000100000000000000000100000000001000001
1001000000000000000000000000000000000001
1111111111111111111111111111111111111111
