NO ./texture_north.xpm
SO ./texture_south.xpm
WE ./texture_west.xpm
EA ./texture_east.xpm

F 220,100,0
C 135,206,235

11111111111111111111111111111
11000000110101011100000010001
10000000000000000000000000001
10000000000000000000000000E01
11000001110101000100011110011
11110111111101000101111010001
11111111111111111111111111111
