NO ./textures/texture_north.xpm
SO ./textures/texture_south.xpm
WE ./textures/texture_west.xpm
EA ./textures/texture_east.xpm

F 100,150,200
C 50,100,150

1111111111111111111111111111111111111111
1000000000000000000000000000000000000001
1000111111100011111100000000000000000001
1000100000000000000100000000000000000001
1000100000000000000100111111111111000001
1000100000000000000100100000000001000001
1000100000000000000100100000000000000001
1000100000000000000100100000000001000001
1000100000000000000100100000000001000001
1000111111100011111100111111111111000001
1000000000000000000000000000000000000001
100000000000E000000000000000000000000001
1000000000000000000000000000000000000001
1000000000000000000000000000000000000001
1000000000000000000000000000000000000001
1001111111111111111111111111111111000001
1001000000000000000000000000000000000001
1001000000000000000000000000000000000001
1001000000000000000000000000000000000001
1001000000000000000000000000000000000001
1111111111111111111111111111111111111111
