NO ./textures/texture7.xpm
SO ./textures/texture6.xpm
WE ./textures/texture8.xpm
EA ./textures/texture9.xpm

F 50,50,50
C 100,150,200

1111111111111111111111111
1000000000110000000000001
1011000001110000000000001
1001000000000000000000001
1111111110110000011100001
1000000000110000011100001
1011000001110000000000001
1001000000000000000000001
1000000011000001110000001
1001000000000000001100001
1001111111110111100100001
1000100000000000000100001
1000111110110000000100001
1000000010110000000100001
1001010011110111100100001
1001010000000100000100001
1000000000000100000100001
1000000100000000010000E01
1111111111111111111111111
