NO ./textures/texture_north.xpm
SO ./textures/texture_south.xpm
WE ./textures/texture_west.xpm
EA ./textures/texture_east.xpm

F 100,150,200
C 50,100,150

1111111111111111111111111111111111111111
1000000000000000000000000000000000000001
10001111111000111111000000000000000000011111111111111
10001000000000000001000000000000000000000000000000001
10001000000000000001001111111111110000011111111111001
10001000000000000001001          1010101        11011
10001000000000000001001          1010001       11001
10001000000000000001001          1010101      110011
10001000000000000001001          1000101     110011
1000111111100011111100111111111111000001    110011
1000000000000000000000000000000000000001   110011
1000000000000000000000000000000000000001  110011
1000000000000E00000000000000000000000001 110011
1000000000000000000000000000000000000001110011
100000000000000000000000000000000000000110011
10011111111111111111111111111111111000010011
1001                              100000011
1001                              10000111
1001111111111111111111111111111111100001
1000000000000000000000000000000000000001
1111111111111111111111111111111111111111
